############
#g-#------E#
#--#P##--###
#S-#-#######
#-----G---p#
#----------#
############