###############
#S--py#-r---Rg#
#--#--#-------#
#----C##-###Y##
#-----P-C----##
#-----#-----GE#
###############