############
#----###0-r#
#-C--YE#####
#G#-R##g1C0#
#----###---#
#S--1###y-##
#----#######
######AAAAAA